ati = ati
aDi = aDi
aDyava = aDi | ava
aDyA = aDi | A
anu = anu
anuni = anu | ni
anuparA = anu | parA
anupra = anu | pra
anuvi = anu | vi
anuvyava = anu | vi | ava
anusam = anu | sam
antar = antar
anvA = anu | A
apa = apa
apA = apa | A
aBi = aBi
aBini = aBi | ni
aBipra = aBi | pra
aBivi = aBi | vi
aBivyA = aBi | vi | A
aBisam = aBi | sam
aByanu = aBi | anu
aByava = aBi | ava
aByA = aBi | A
aByut = aBi | ut
aByupa = aBi | upa
aByupA = aBi | upa | A
ava = ava
A = A
Apa = A | apa
Apra = A | pra
Avis = Avis
ut = ut
utpra = ut | pra
udA = ut | A
upa = upa
upani = upa | ni
upasam = upa | sam
upA = upa | A
upAti = upa | ati
upADi = upa | aDi
upot = upa | ut
tiras = tiras
ni = ni
nirava = nis | ava
nirA = nis | A
nis = nis
parA = parA
pari = pari
parini = pari | ni
parisam = pari | sam
paryA = pari | A
paryut = pari | ut
paryupa = pari | upa
puras = puras
pra = pra
praRi = pra | ni
prati = prati
pratini = prati | ni
pratipra = prati | pra
prativi = prati | vi
pratisam = prati | sam
pratyapa = prati | apa
pratyaBi = prati | aBi
pratyava = prati | ava
pratyA = prati | A
pratyut = prati | ut
pratyudA = prati | ut | A
pravi = pra | vi
pravyA = pra | vi | A
prA = pra | A
prot = pra | ut
bahis = bahis
vi = vi
vini = vi | ni
vinis = vi | nis
viparA = vi | parA
vipari = vi | pari
vipra = vi | pra
viprati = vi | prati
visam = vi | sam
vyati = vi | ati
vyapa = vi | apa
vyapA = vi | apa | A
vyaBi = vi | aBi
vyava = vi | ava
vyA = vi | A
vyut = vi | ut
saMvi = sam | vi
saMvyava = sam | vi | ava
sanni = sam | ni
sam = sam
samanu = sam | anu
samaBi = sam | aBi
samaBivi = sam | aBi | vi
samaBivyA = sam | aBi | vi | A
samava = sam | ava
samA = sam | A
samut = sam | ut
samudA = sam | ut | A
samudvi = sam | ut | vi
samupa = sam | upa
sampra = sam | pra
samprati = sam | prati
sampravi = sam | pra | vi
